___############
_#_#____##____#
_#_#_#_____##_#
##_#_#######__#
#_____#____####
#_###_#_##_#__#
#_#_#_#_#__##_#
#_#_#_#_#_##__#
#_#_#_#_####_##
###_#_#_______#
###_#_#_#####_#
#_#_#_______#_#
#_#_#_#_###_#_#
#_#_###_#_#_#_#
#_________#_###